
EA ./textures/lduthill.xpm
NO ./textures/lduthill.xpm
SO ./textures/lduthill.xpm
WE ./textures/lduthill.xpm

C 189,166,0
F 123,97,39

    11111111111111  11111111111111
   1000000000000001100000000001001
  100000000001000001000000000000111
1100000000001 1000000000000000001
1000000000000100000110000000000001
11000000000000010000000000000000001
  1100000000000111000000000000000001
   10000000000010100000000000000000011
  1000000000000111000000000011100001
 1000000000000000000000000001010001
 10000000000000000000000000E001001
 100000000000000000000000000001001
 100000000000000000000000000001001
 100000000000000000001000000001001
 10000000000000000000010000001001
 100000000000000000000000000001001
111111111111111111111111111111111
