
EA ./textures/ea.xpm
NO ./textures/we.xpm
SO ./textures/window.xpm
WE ./textures/ea.xpm

C 4,255,233
F 87,149,24

        1111111111111111111111111
        1000000000110000000000001
        1011000001110000000000001
        1001000000000000000000001
111111111011000001110000000000001
1000000000110000011111111111111111
11110111111111011100000010001
11111111111111011101010010001
11000000110101111100000010001
10000000000000001100000010001
10000000W00000001101010010001
1100000111010101111101111000111
11110111 1110101 101111010001
11111111 1111111 111111111111
