
EA ./textures/wall.xpm
NO ./textures/wall.xpm
SO ./textures/wall.xpm
WE ./textures/wall.xpm

C 189,166,0
F 123,97,39

    11111111111111  11111111111111
   1000000000000001100000000001001
  100000000001000001000000000000111
1100000000001 1000000000000000001
1000000000000100000110000000000001
11000000000000010000000000000000001
  1100000000000111000000000000000001
   10000000000010100000000000W00000011
  1000000000000111000000000000000001
 1000000000000000000000000000000001
 100000000000000000000000000000001
 100000000000000000000000000000001
111111111111111111111111111111111
